{
  "id": "starter-town",
  "name": "Starter Town",
  "width": 20,
  "height": 15,
  "tileSize": 32,
  "backgroundTile": 1,
  "tiles": [
    2, 2, 2, 2, 2, 2, 2, 2, 2, 2, 2, 2, 2, 2, 2, 2, 2, 2, 2, 2,
    2, 1, 1, 1, 1, 1, 1, 1, 1, 1, 1, 1, 1, 1, 1, 1, 1, 1, 1, 2,
    2, 1, 1, 1, 1, 1, 1, 1, 1, 1, 1, 1, 1, 1, 1, 1, 1, 1, 1, 2,
    2, 1, 1, 3, 3, 1, 1, 1, 1, 1, 1, 1, 3, 3, 3, 1, 1, 1, 1, 2,
    2, 1, 1, 3, 3, 1, 1, 1, 1, 1, 1, 1, 3, 3, 3, 1, 1, 1, 1, 2,
    2, 1, 1, 1, 1, 1, 1, 1, 1, 1, 1, 1, 1, 1, 1, 1, 1, 1, 1, 2,
    2, 1, 1, 1, 1, 1, 1, 1, 1, 1, 1, 1, 1, 1, 1, 1, 1, 1, 1, 2,
    2, 1, 1, 1, 1, 1, 4, 4, 4, 4, 1, 1, 1, 1, 1, 1, 1, 1, 1, 2,
    2, 1, 1, 1, 1, 1, 4, 4, 4, 4, 1, 1, 1, 1, 1, 1, 1, 1, 1, 2,
    2, 1, 1, 1, 1, 1, 1, 1, 1, 1, 1, 1, 1, 1, 1, 1, 1, 1, 1, 2,
    2, 1, 1, 1, 1, 1, 1, 1, 1, 1, 1, 1, 1, 1, 1, 1, 1, 1, 1, 2,
    2, 1, 1, 1, 1, 1, 1, 1, 1, 1, 1, 1, 1, 1, 1, 1, 1, 1, 1, 2,
    2, 1, 1, 1, 1, 1, 1, 1, 1, 1, 1, 1, 1, 1, 1, 1, 1, 1, 1, 2,
    2, 1, 1, 1, 1, 1, 1, 1, 1, 1, 1, 1, 1, 1, 1, 1, 1, 1, 1, 2,
    2, 2, 2, 2, 2, 2, 2, 2, 2, 2, 2, 2, 2, 2, 2, 2, 2, 2, 2, 2
  ],
  "collisions": {
    "2": true,
    "3": true,
    "4": true
  },
  "grassTiles": [1],
  "playerSpawn": {
    "x": 10,
    "y": 7
  },
  "npcs": [
    {
      "id": "npc-1",
      "name": "Elder",
      "x": 3,
      "y": 3,
      "dialogue": "Welcome to Starter Town!"
    },
    {
      "id": "npc-2",
      "name": "Merchant",
      "x": 15,
      "y": 4,
      "dialogue": "Need supplies? Visit the shop!"
    }
  ],
  "trainers": [
    {
      "id": "trainer-npc-1",
      "name": "Youngster Joey",
      "x": 8,
      "y": 10,
      "trainerId": "trainer-1"
    }
  ]
}
