{
  "id": "starter-forest",
  "name": "Starter Forest",
  "width": 24,
  "height": 18,
  "tileSize": 32,
  "backgroundTile": 5,
  "tiles": [
    5, 5, 5, 5, 5, 5, 5, 5, 5, 5, 5, 5, 5, 5, 5, 5, 5, 5, 5, 5, 5, 5, 5, 5,
    5, 6, 6, 6, 6, 6, 6, 5, 5, 5, 5, 5, 5, 5, 5, 5, 5, 5, 5, 5, 5, 5, 5, 5,
    5, 6, 1, 1, 1, 6, 6, 5, 5, 5, 1, 1, 1, 1, 1, 5, 5, 5, 5, 5, 5, 5, 5, 5,
    5, 6, 1, 1, 1, 1, 6, 5, 5, 1, 1, 1, 1, 1, 1, 1, 5, 5, 5, 5, 5, 5, 5, 5,
    5, 6, 1, 1, 1, 1, 6, 5, 5, 1, 1, 1, 1, 1, 1, 1, 5, 5, 5, 5, 5, 5, 5, 5,
    5, 6, 6, 1, 1, 6, 6, 5, 5, 1, 1, 1, 1, 1, 1, 1, 5, 5, 5, 5, 5, 5, 5, 5,
    5, 5, 6, 6, 6, 6, 5, 5, 5, 5, 1, 1, 1, 1, 1, 5, 5, 5, 5, 5, 5, 5, 5, 5,
    5, 5, 5, 5, 5, 5, 5, 5, 5, 5, 1, 1, 1, 1, 1, 5, 5, 5, 5, 5, 5, 5, 5, 5,
    5, 5, 5, 5, 5, 5, 5, 5, 5, 5, 5, 1, 1, 1, 5, 5, 5, 5, 5, 5, 5, 5, 5, 5,
    5, 5, 5, 5, 5, 5, 1, 1, 1, 1, 5, 5, 5, 5, 5, 5, 5, 5, 5, 5, 5, 5, 5, 5,
    5, 5, 5, 5, 5, 5, 1, 1, 1, 1, 5, 5, 5, 5, 5, 5, 1, 1, 1, 5, 5, 5, 5, 5,
    5, 5, 5, 5, 5, 5, 1, 1, 1, 1, 5, 5, 5, 5, 5, 5, 1, 1, 1, 5, 5, 5, 5, 5,
    5, 5, 5, 5, 5, 5, 5, 1, 1, 5, 5, 5, 5, 5, 5, 5, 1, 1, 1, 5, 5, 5, 5, 5,
    5, 5, 5, 5, 5, 5, 5, 5, 5, 5, 5, 5, 5, 5, 5, 5, 5, 5, 5, 5, 5, 5, 5, 5,
    5, 5, 5, 5, 5, 5, 5, 5, 5, 5, 5, 5, 5, 5, 5, 5, 5, 5, 5, 5, 5, 5, 5, 5,
    5, 5, 5, 5, 5, 5, 5, 5, 5, 5, 5, 5, 5, 5, 5, 5, 5, 5, 5, 5, 5, 5, 5, 5,
    5, 5, 5, 5, 5, 5, 5, 5, 5, 5, 5, 5, 5, 5, 5, 5, 5, 5, 5, 5, 5, 5, 5, 5,
    5, 5, 5, 5, 5, 5, 5, 5, 5, 5, 5, 5, 5, 5, 5, 5, 5, 5, 5, 5, 5, 5, 5, 5
  ],
  "collisions": {
    "5": true,
    "6": true
  },
  "grassTiles": [1],
  "playerSpawn": {
    "x": 12,
    "y": 9
  },
  "npcs": [
    {
      "id": "forest-npc-1",
      "name": "Ranger",
      "x": 3,
      "y": 3,
      "dialogue": "Wild critters thrive in these forests!"
    }
  ],
  "trainers": []
}
